##################################################
#P__________________D_________________________E___#
#__________________D_________________________E___#
#__________________D_________________________E___#
#__________________D_________________________E___#
#__________________D_________________________E___#
#__________________D_________________________E___#
#__________________D_________________________E___#
#__________________D_________________________E___#
#__________________D_________________________E___#
#__________________D_________________________E___#
#__________________D_________________________E___#
#__________________D_________________________E___#
#__________________D_________________________E___#
#__________________D_________________________E___#
#__________________D_________________________E___#
#__________________D_________________________E___#
#__________________D_________________________E___#
#__________________D_________________________E___#
#__________________D_________________________E___#
#__________________D_________________________E___#
#__________________D_________________________E___#
#__________________D_________________________E___#
#__________________D_________________________E___#
#__________________D_________________________E___#
#__________________D_________________________E___#
#__________________D_________________________E___#
#__________________D_________________________E___#
#__________________D_________________________E___#
#__________________D_________________________E___#
#__________________D_________________________E___#
#__________________D_________________________E___#
#__________________D_________________________E___#
#__________________D_________________________E___#
#__________________D_________________________E___#
#__________________D_________________________E___#
#__________________D_________________________E___#
#__________________D_________________________E___#
#__________________D_________________________E___#
#__________________D_________________________E___#
#__________________D_________________________E___#
#__________________D_________________________E___#
#__________________D_________________________E___#
#__________________D_________________________E___#
#__________________D_________________________E___#
#__________________D_________________________E___#
#__________________D_________________________E___#
#__________________D_________________________E___#
##################################################