##################################################
#P_______D___________________________E#############
#____________________________________D_____________#
#____________________________________D_____________#
#__________________________________________________#
#__________________________________________________#
##################################################