##################################################
#P______________________________________________#
#______________________________________________E#
#______________________________________________E#
##################################################
