##################################################
#P____#____#____#____#____#____#____#____#____E#####
#_____#____#____#____#____#____#____#____#__________#
#_____#____#____#____#____#____#____#____#__________#
#_____#____#____#____#____#____#____#____#__________#
#____D#D__D#D__D#D__D#D__D#D__D#D__D#D__D__________#
#_____#____#____#____#____#____#____#____#__________#
#_____#____#____#____#____#____#____#____#__________#
#_____#____#____#____#____#____#____#____#__________#
#____D#D__D#D__D#D__D#D__D#D__D#D__D#D__D__________#
#_____#____#____#____#____#____#____#____#__________#
#_____#____#____#____#____#____#____#____#__________#
#_____#____#____#____#____#____#____#____#__________#
#____D#D__D#D__D#D__D#D__D#D__D#D__D#D__D__________#
#_____#____#____#____#____#____#____#____#__________#
#_____#____#____#____#____#____#____#____#__________#
##################################################