##################################################
#P_____##D#######D#######D#######D#######D####E#
#______##D#######D#######D#######D#######D####E#
#______##D#######D#######D#######D#######D####E#
#______##D#######D#######D#######D#######D####E#
#______##D#######D#######D#######D#######D####E#
#______##D#######D#######D#######D#######D####E#
#______##D#######D#######D#######D#######D####E#
#______##D#######D#######D#######D#######D####E#
#______##D#######D#######D#######D#######D####E#
#______##D#######D#######D#######D#######D####E#
#______##D#######D#######D#######D#######D####E#
#______##D#######D#######D#######D#######D####E#
#______##D#######D#######D#######D#######D####E#
#______##D#######D#######D#######D#######D####E#
#______##D#######D#######D#######D#######D####E#
#______##D#######D#######D#######D#######D####E#
#______##D#######D#######D#######D#######D####E#
#______##D#######D#######D#######D#######D####E#
#______##D#######D#######D#######D#######D####E#
#______##D#######D#######D#######D#######D####E#
#______##D#######D#######D#######D#######D####E#
#______##D#######D#######D#######D#######D####E#
#______##D#######D#######D#######D#######D####E#
#______##D#######D#######D#######D#######D####E#
#______##D#######D#######D#######D#######D####E#
#______##D#######D#######D#######D#######D####E#
#______##D#######D#######D#######D#######D####E#
#______##D#######D#######D#######D#######D####E#
#______##D#######D#######D#######D#######D####E#
#______##D#######D#######D#######D#######D####E#
#______##D#######D#######D#######D#######D####E#
#______##D#######D#######D#######D#######D####E#
#______##D#######D#######D#######D#######D####E#
#______##D#######D#######D#######D#######D####E#
#______##D#######D#######D#######D#######D####E#
#______##D#######D#######D#######D#######D####E#
#______##D#######D#######D#######D#######D####E#
#______##D#######D#######D#######D#######D####E#
#______##D#######D#######D#######D#######D####E#
#______##D#######D#######D#######D#######D####E#
#______##D#######D#######D#######D#######D####E#
#______##D#######D#######D#######D#######D####E#
#______##D#######D#######D#######D#######D####E#
#______##D#######D#######D#######D#######D####E#
#______##D#######D#######D#######D#######D####E#
#______##D#######D#######D#######D#######D####E#
#______##D#######D#######D#######D#######D####E#
##################################################