##################################################
#P_________________________________________________E#
#_________________________________________________E#
#_________########################################_#
#_________#_______________________________________D#
#_________#_____D_____D_____D_____D_____D__________D#
#_________#_______________________________________D#
#_________#_______________________________________D#
#_________#_______________________________________D#
#_________#_______________________________________D#
#_________#_______________________________________D#
#_________#_______________________________________D#
#_________#_______________________________________D#
#_________#_______________________________________D#
#_________#_______________________________________D#
#_________########################################_#
#_________________________________________________E#
#_________________________________________________E#
##################################################