##################################################
#P____________________#_________________________#
#_____________________D________________________E#
#_____________________#________________________E#
##################################################
