##################################################
#P_____###___###_____________________E##############
#_______#___#___#____________________E##############
#_______#___#___#_________________________D________#
#_______###___###_________________________D________#
#__________________________________________________#
#______________###__________________________########
#______________#_#__________________________#______D#
#______________#_#__________________________#______D#
#______________###__________________________#______D#
#__________________________________________#######D#
##################################################